111111111111111
140000000000001
100100000000001
111100000000001
100000000000001
100111101111001
100100000021001
100120333021001
100120000001001
100111110111001
100000000000001
100000000001101
100000000001001
100000000001051
111111111111111