111111111111111
140000000000001
101111122111101
101300000003101
101000000000101
101000000000101
101000000000101
102000000000201
102000000000201
101000000000101
101000000000101
101300000003101
101111122111101
100000000000051
111111111111111