111111111111111
223300040002233
101010101010101
000000000000000
101010101010101
000000000000000
101010101010101
000000000000000
101010101010101
000000000000000
101010101010101
000000000000000
101010101010101
223300050002233
111111111111111