666666666666666
666666666666666
666666666666666
666666666666666
666666666666666
661111111111166
661040232000166
661000232000166
661000232050166
661111111111166
666666666666666
666666666666666
666666666666666
666666666666666
666666666666666
