111111111111111
142222222222221
133333333333331
122222222222221
133333333333331
122222222222221
133333333333331
122222222222221
133333333333331
122222222222221
133333333333331
122222222222221
133333333333331
122222222222251
111111111111111