111111111111111
100000415000001
100000010000001
100000010000001
100000010000001
100000010000001
100000010000001
100000010000001
100000212000001
100000000000001
111110000011111
100020000020001
100000000000001
130000000000031
111111111111111