111111111111111
130303030303031
103030303030301
120202020202021
100000000000001
101010101010101
100000040000001
101010101010101
100000050000001
101010101010101
100000000000001
120202020202021
130303030303031
103030303030301
111111111111111