111111111111111
100000000000001
100000000000001
100011111110001
100015000010001
100011000110001
100000000000001
100000040000001
111111111111111
666666666666666
116616161161661
161616161661616
161616161661166
161616161661616
116611161161661
