111111111111111
100000000000001
100011111110001
100000000000001
100000100011111
111110100000001
100000100000001
100400100000001
100000100000001
100000100011111
101000000000001
101000000000001
101000100010011
101000100010051
111111111111111
