111111111111111
100000010000001
100000010000001
111110010111111
100000010000001
100000010000001
101111111111101
100000010000001
100000010000001
111111010111111
100000010000001
100000010000001
110101011010101
100400010050001
111111111111111
